Guarulhos - São Paulo
Santos Dumont - Rio de Janeiro
Afonso Pena - Curitiba
Aeroporto de Brasilia - Brasilia
Salgado Filho - Porto Alegre
Gilberto Freye - Recife
Pinto Martins - Fortaleza
Luís Eduardo Magalhães - Salvador
Eurico Aguiar Salles - Vitória
Hercílio Luz - Florianópolis
Governador José Rica - Londrina
Confins - Confis
Eduardo - Gomes - Manaus
Cataratas - Foz do Iguaçú
Julio Cezar Ribeiro - Belém do Pará
Santa Genoveva - Goiania
Aeroporto Internacional de Campo Grande
Ministro Victor Konder - Navegantes
Marechal Rondon - Cuiabá
Zumbi dos Palmares - Maceió
Santa Maria - Aracajú
Lauro Carneiro de Loyola - Joinville
Marechal Cunha Machado - São Luis
Ten. Cel. Aviador César Bombonato - Uberlândia
Senador Petrônio Portella - Teresina
Aeroporto Internacional de Natal
Pampulha - Belo Horizonte
Governador Jorge Teixeira de Oliveira - Porto Velho
Jorge Amado - Ilhéus
Brigadeiro Lysias Rodrigues - Palmas